                     ####  ####  #### ####                  
                     #..#  #..#  #..# #..#                  
                    ##..####..####..###..###                
                    #......................###              
                    #........................#              
                  ###..###...###.............#              
                  #....###...###...........###              
                  #......#####.............#                
                  ###....#####.............###              
                    #..#########.............#              
                    #..###..####.............#              
    ####   #### #####..###..#..............#######   ####   
    #..#   #..# #...........#..............#  #..#   #..#   
#####..#####..###...........###............####..#####..####
..............................#.............................
..............................#.............................
............................###.............................
............................#...............................
............................#...............................
............................###.............................
#####..#####..###.............#............####..#####..####
    #..#   #..# #.............#............#  #..#   #..#   
    ####   #### #...........#####..##..#####  ####   ####   
                #...........#   #..##..###                  
              ###...........### #####....#                  
              #...............#   #......#                  
              #...............#   #....###                  
              ###...........#########..#                    
                #...........#  #..# #..###                  
              ###...........####..###....#                  
              #..........................#                  
              #........................###                  
              ###..####..####..####..###                    
                #..#  #..#  #..#  #..#                      
                ####  ####  ####  ####                      
                                                            