                                                            
                                                            
                                                            
                                                            
                                                            
                                                            
                                                            
                                                            
                                                            
                                                            
                                                            
    ####   ####   ####   ####   ####   ####   ####   ####   
    #..#   #..#   #..#   #..#   #..#   #..#   #..#   #..#   
#####..#####..#####..#####..#####..#####..#####..#####..####
............................................................
............................................................
............................................................
............................................................
............................................................
............................................................
#####..#####..#####..####...........####..#####..#####..####
    #..#   #..#   #..#  #...........#  #..#   #..#   #..#   
    ####   ####   #######...........#######   ####   ####   
                      #...............#                     
                      #...............#                     
                      ###...........###                     
                        #...........#                       
                      ###...........###                     
                      #...............#                     
                      #...............#                     
                      ###...........###                     
                        ##..#####..##                       
                         #..#   #..#                        
                         ####   ####                        
                                                            
                                                            