                                                            
                                                            
                                                            
                                                            
                    #####################                   
                    #...................#                   
                  ###...................###                 
                  #.......................#                 
                  #.......................#                 
                  #.......................#                 
                  #......####...####......#                 
    ####   ####   #......#  #...#  #......#   ####   ####   
    #..#   #..#   #......#  #####  #......#   #..#   #..#   
#####..#####..#####......#         #......#####..#####..####
..................#......###     ###......#.................
..................#........#     #........#.................
..................+........#     #........+.................
..................+........#     #........+.................
..................#........#     #........#.................
..................#......###     ###......#.................
#####..#####..#####......#         #......#####..#####..####
    #..#   #..#   #......#  #####  #......#   #..#   #..#   
    ####   ####   #......#  #...#  #......#   ####   ####   
                  #......####...####......#                 
                  #.......................#                 
                  #.......................#                 
                  ###...................###                 
                    #...................#                   
                    #####################                   
                                                            
                                                            
                                                            
                                                            
                                                            
                                                            
                                                            