                                                            
                                                            
                                                            
                                                            
                    #####################                   
                    #...................#                   
                  ###...................###                 
                  #.......................#                 
                  #.......................#                 
                  #.......................#                 
                  #.......................#                 
    ####   ####   #.......................#   ####   ####   
    #..#   #..#   #.......................#   #..#   #..#   
#####..#####..#####.......................#####..#####..####
..................#.......................#.................
..................#.......................#.................
..................+.......................+.................
..................+.......................+.................
..................#.......................#.................
..................#.......................#.................
#####..#####..#####.......................#####..#####..####
    #..#   #..#   #.......................#   #..#   #..#   
    ####   ####   #.......................#   ####   ####   
                  #.......................#                 
                  #.......................#                 
                  #.......................#                 
                  ###...................###                 
                    #...................#                   
                    #####################                   
                                                            
                                                            
                                                            
                                                            
                                                            
                                                            
                                                            