                                                            
                                                            
                                                            
                                                            
                                                            
                                                            
                                                            
                          #### ####                         
                          #..# #..#                         
                         ##..###..##                        
                        ##.........##                       
  ####   ####  ####   ###...........### ####  ####  ####    
  #..#   #..#  #..# ###...............###..#  #..#  #..#    
###..#####..####..###..................##..####..####..#####
....................#.......................................
....................##......................................
.....................#.###&####.............................
.....................###......##............................
......................#........#............................
......................##......###...........................
###..#####..###........####&###.###..####..####..####..#####
  #..#   #..# #.................###..#  #..#  #..#  #..#    
  ####   #### ##................######  ####  ####  ####    
               #................#                           
               ##..............##                           
                #.............##                            
                ##..#####..####                             
                 #..#   #..#                                
                 ####   ####                                
                                                            
                                                            
                                                            
                                                            
                                                            
                                                            
                                                            
