                                                            
                                                            
                    ####  ####  ####                        
                    #..#  #..#  #..#                        
                 ####..####..####..#####                    
                 #.....................#                    
               ###.....................###                  
               #.........................#                  
               #.........................#                  
               ###.....................###                  
                 #.....................#                    
    ####   ####  #.....####..#####..####      ####   ####   
    #..#   #..#  #.....#  #..#   #..#         #..#   #..#   
#####..#####..####.....#  ####   ##############..#####..####
.......................#         ###........................
.......................###       #..........................
.........................#       #..........................
.........................#       ###........................
.......................###         #........................
.......................#         ###........................
#####..#####..####.....###       #.........####..#####..####
    #..#   #..#  #.......#       #.........#  #..#   #..#   
    ####   ####  #.......#       ###.......#  ####   ####   
               ###.....###         #.......###              
               #.......# #### #### #.........#              
               #.......# #..# #..# #.........#              
               ###.....###..###..###.......###              
                 #.........................#                
               ###.........................###              
               #.............................#              
               #.............................#              
               ###.........................###              
                 ######..#####..#####..#####                
                      #..#   #..#   #..#                    
                      ####   ####   ####                    
                                                            