                                                                                                                                            
                                                                                                                                            
                                                                                                                                            
                                                                                                                                            
                                                                                                                                            
                                                                                                                                            
                                                                                                                                            
                                                                                                                                            
                                                                                                                                            
                                                                                                                                            
                                                                                                                                            
                                                ###############################                                                             
                                               #...............................#                                                            
                                               #...............................#                                                            
                                               #...............................#                                                            
                                               #...............................#           ###############################                  
                                               #...............................############...............................#                 
                                               #..........................................................................#                 
                                               #..........................................................................#                 
                                               #..........................................................................#                 
                                               #..........................................................................#                 
                                               #..........................................................................#                 
                                               #..........................................................................#                 
                                               #..........................................................................#                 
                                               #..........................................................................#                 
                                               #..........................................................................#                 
                                               #..........................................................................#                 
                                               #..........................................................................#                 
                                               #..........................................................................#                 
                                               #..........................................................................#                 
                                               #..........................................................................#                 
                                               #..........................................................................#                 
     ###############################           #..........................................................................#                 
    #...............................#          #..........................................................................#                 
    #...............................#          #..........................................................................#                 
    #...............................#          #..........................................................................#                 
    #...............................#          #..........................................................................#                 
    #...............................#          #..........................................................................#                 
    #...............................#          #..........................................................................#                 
    #...............................#          #..........................................................................#                 
    #...............................#          #..........................................................................#                 
    #...............................#          #..........................................................................#                 
    #...............................#          #..........................................................................#                 
    #...............................#           #############.............................................................#                 
    #...............................#  ######################.............................................................##########        
    #...............................# #.............................................................................................#       
    #...............................# #...........................................................####..............................#       
    #...............................# #...........................................................#  #..............................#       
    #...............................# #...........................................................#  #..............................#       
    #...............................# #...........................................................#  #..............................#       
    #...............................# #...........................................................#  #..............................#       
    #...............................# #...........................................................#  #..............................#       
    #...............................# #...........................................................#  #..............................#       
    #...............................# #...........................................................#  #..............................#       
    #...............................# #...........................................................#  #..............................#       
    #...............................# #...........................................................#  #..............................#       
    #...............................# #...........................................................#  #..............................#       
    #...............................# #...........................................................#  #..............................#       
    #...............................# #......................................................#####   #..............................#       
    #...............................# #......................................................#       #..............................#       
    #...............................# #......................................................#       #..............................#       
    #...............................# #......................................................#       #..............................#       
    #...............................# #......................................................#       #..............................#       
     ###############################  #......................................................#       #..............................#       
                                      #......................................................#       #..............................#       
                                      #......................................................#       #..............................#       
                                      #......................................................#       #..............................#       
                                      #......................................................#       #..............................#       
                                      #......................................................#       #..............................#       
                                      #......................................................#       #..............................#       
                                      #......................................................#       #..............................#       
                                      #......................................................#       #..............................#       
                                      #......................................................#       #..............................#       
                                      #......................................................#       #..............................#       
                                     #.......................................................#       #..............................#       
                                     #.......................................................#        ##############################        
                                     #.......................................................#                                              
                                     #.......................................................#                                              
                                     #...........................................############      ##############################           
                                     #...........................................#                #..............................#          
                                     #...........................................#                #..............................#          
                                     #...........................................#                #..............................#          
                                     #...........................................#                #..............................#          
                                     #...........................................#                #..............................#          
                                     #...........................................#                #..............................#          
                                     #...........................................#                #..............................#          
                                     #...........................................#                #..............................#          
                                     #...........................................#                #..............................#          
                                     #...........................................#               ##..............................#          
                                     #...........................................#        #######................................#          
                                     #...........................................#       #.......................................#          
                                     #...........................................#########.......................................#          
                                     #...........................................................................................#          
                                     #...........................................................................................#          
                                     #...........................................................................................#          
                                     #...........................................................................................#          
                                     #...........................................................................................#          
         #############################...........................................................................................#          
        #........................................................................................................................#          
        #........................................................................................................................#          
        #........................................................................................................................#          
        #........................................................................................................................#          
        #........................................................................................................................#          
        #........................................................................................................................#          
        #........................................................................................................................#          
        #..............................###########...............................................................................#          
        #..............................#         #...............................................................................#          
        #..............................#        ##...............................................................................#          
        #..............................#       #.................................................................................#          
        #..............................#       #.................................................................................#          
        #..............................#       #................................................................................#           
        #..............................#       #................................................................................#           
        #..............................#       #................................................................................#           
        #..............................#       #................................................................................#           
        #..............................#       #................................................................................#           
        #..............................#       #................................................................................#           
        #..............................#       #................................................................................#           
        #..............................#       #................................................................................#           
        #..............................#       #................................................................................#           
        #..............................#       #................................................................................#           
        #..............................#       #................................................................................#           
        #..............................#       #................................................................................#           
        #..............................#       #................................................................................#           
        #..............................#       #................................................................................#           
        #..............................#       #................................................................................#           
        #..............................#       #................................................................................#           
        #..............................#       #......................................############..............................#           
        #..............................#       #......................................#          #..............................#           
        #..............................#       #......................................#          #..............................#           
         ##############################        #......................................#          #..............................#           
                                               #......................................#          #..............................#           
                                               #...............................#######           #..............................#           
                                               #...............................#                 #..............................#           
                                               #...............................#                 #..............................#           
                                               #...............................#                 #..............................#           
                                               #...............................#                 #..............................#           
                                               #...............................#                 #..............................#           
                                               #...............................#                 #..............................#           
                                                ###############################                   ##############################            
                                                                                                                                            
