                                        
 ######                                 
#......###########                      
#.................#  #######            
#.................# #.......#           
#.................# #.......#           
#.................# #.......#           
#.................###.......#           
#...........................#           
 ######.....................#           
       #########............#           
                #.........##            
                #.........#      ###### 
                #.........#     #......#
                #.........#     #......#
                #.........###  #.......#
                #............###.......#
                #......................#
                #......................#
                 ###...................#
                    ##.......###.......#
     #######         #.......# #.......#
    #.......#        #.......#  ####### 
    #.......#         #....##           
  ###.......##        #....#    ######  
 #............#########....#   #......# 
 #................#........#####......# 
 #................#...................# 
 #................#...................# 
 #................#........#####......# 
#..........................#   #......# 
#..........................#    ######  
#......####.........#......#            
#......#   ##.......#......#            
#......#    #.......#......#            
#......#    #.......#######             
#......#     #######                    
 ######                                 
                                        
                                        
