                                                                                                                                            
                                                                                                                                            
                                                                                                                                            
                                                                                                                                            
                                                                                                                                            
                                                                                                                                            
                                                                                                                                            
                                                                                                                                            
                                   #########################                                                                                
                                  #.........................#                                                                               
                                  #.........................#                                                                               
                                  #.........................#                                                                               
                                  #.........................#                                                                               
                                  #.........................#                                                                               
                                  #.........................#                                                                               
                                  #.........................#                                                                               
                                  #.........................#                                                                               
                               ####.........................#                                                                               
                              #.............................#                                                                               
                              #.............................#                                                                               
                              #.............................#     #########################                                                 
                              #.............................#    #.........................#                                                
                              #.............................#    #.........................#                                                
                        #######.............................#    #.........................#                                                
                       #....................................#    #.........................#                                                
                       #....................................#    #.........................#                                                
                       #....................................#    #.........................#                                                
                       #....................................#    #.........................#                                                
                       #....................................#    #.........................#                                                
                       #....................................#    #.........................#                                                
                       #....................................#    #.........................#                                                
                       #....................................#    #.........................#                                                
                       #....................................#    #.........................#                                                
                       #....................................#    #.........................#                                                
                       #................................####     #.........................####################                             
                       #................................#        #.............................................#                            
                       #................................#        #.............................................#                            
                       #................................#    #####.............................................#                            
                       #................................#   #..................................................#                            
                       #................................#   #..................................................#                            
                       #................................#   #..................................................########                     
                       #................................#   #..........................................................#                    
                       #................................#   #..........................................................#                    
                       #.............................###    #..........................................................#                    
                       #.............................#      #..........................................................#                    
                       #.............................#      #..........................................................#                    
                       #.............................#      #..........................................................#                    
                       #.............................#      #..........................................................#                    
                       #.............................#      #..........................................................#                    
                        ###..........................#      #..........................................................#                    
                         #...........................#     #...........................................................#                    
                         #...........................#     #...........................................................#                    
                         #...........................#     #...........................................................#                    
                         #...........................#     #...........................................................#                    
                         #...........................#     #...........................................................#                    
                         #...........................#     #...........................................................#                    
                         #...........................#     #...........................................................#                    
                         #...........................#     #...........................................................#                    
                         #...........................#     #...........................................................#                    
                         #...........................#     #...........................................................#                    
                         #...........................#     #...........................................................#                    
                         #...........................#     #...........................................................#                    
                         #.........................##      #...........................................................#                    
                         #.........................#       #...........................................................#                    
                         #.........................#       #...........................................................#                    
                         #.........................#       #...........................................................#                    
                         #.........................#       #........................................................###                     
                         #.........................#       #........................................................#                       
                         #.........................#       #........................................................#                       
                         #.........................#       #........................................................#                       
                         #.........................#       #........................................................#                       
                         #.........................#       #........................................................#                       
                         #.........................#       #........................................................#                       
                         #.........................#       #........................................................#                       
                         #.........................#       #........................................................#                       
                          #########################         ##......................................................#                       
                                                             #..........................##..........................#                       
                                                             #..........................##..........................#                       
                                                             #..........................##..........................#                       
  ##########################                                 #..........................##..........................#                       
 #..........................#                                #......................................................#                       
 #..........................#                                #......................................................#                       
 #..........................#                                #......................................................#                       
 #..........................#                                #......................................................#                       
 #..........................#                                #......................................................#                       
 #..........................#                                #......................................................#                       
 #..........................#                                #......................................................#                       
 #..........................#                                #......................................................#                       
 #..........................#                                #......................................................#                       
 #..........................#                                #.....................................#################                        
 #..........................#                                #.....................................#                                        
 #..........................#                                #.....................................######                                   
 #..........................#                                #...........................................#                                  
 #..........................#                                #...........................................#                                  
 #..........................#                        #########...........................................#                                  
 #..........................#                       #....................................................#                                  
 #..........................#                       #....................................................#                                  
 #..........................#                       #....................................................#######                            
 #..........................#                 #######...........................................................###                         
 #..........................#                #.....................................................................#                        
 #..........................#                #.....................................................................#                        
 #..........................#                #.....................................................................#                        
 #..........................#                #.....................................................................#                        
 #..........................#                #.....................................................................#                        
 #..........................#                #.....................................................................#                        
  ##########################                 #.....................................................................#                        
                                             #.....................................................................#                        
                                             #.....................................................................#                        
                                             #.....................................................................#                        
                                             #.....................................................................#                        
                                             #.....................................................................#                        
                                             #.....................................................................#                        
                                             #.....................................................................#                        
                                             #.....................................................................#                        
                                             #.....................................................................#                        
                                             #.....................................................................#                        
                                             #.....................................................................#                        
                                             #.................................#######.............................#                        
                                             #.................................#     #.............................#                        
                                             #.................................#     #.............................#                        
                                             #.........................########      #.............................#                        
                                             #.........................#             #.............................#                        
                                             #.........................#             #.............................#                        
                                             #.........................#              ####.........................#                        
                                              #########################                  #.........................#                        
                                                                                          #########################                         
                                                                                                                                            
                                                                                                                                            
                                                                                                                                            
                                                                                                                                            
                                                                                                                                            
                                                                                                                                            
                                                                                                                                            
                                                                                                                                            
                                                                                                                                            
                                                                                                                                            
                                                                                                                                            
                                                                                                                                            
                                                                                                                                            
                                                                                                                                            
