                            #######     
                           #.......#    
            ######         #.......#    
           #......#        #.......#    
           #......#     ####.......#    
           #......#    #...........#    
           #......#    #...........#    
           #......#    #...........#    
           #......#   #..........##     
            ######    #..........#      
                      #..........#      
                      #..........#      
                 ######..........#      
                #................#      
                #......##########       
          #######..............#        
         #.....................#        
         #.....................#        
         #.....................#        
         #.....................#        
         #........#............#        
         #........#........####         
          #.......#......##             
          #.........#####  #######      
          #.........#     #.......#     
          #.........#     #.......#     
       ####..........#    #.......#     
      #..............#    #.......#     
      #..............#    #.......#     
      #.......#......######.......#     
      #.......#......#............#     
      #.......#......#............#     
      #.......#......#............#     
      #.......########.......#####      
       #######       #.......#          
                     #.......#          
                      #######           
                                        
                                        
                                        
