                                        
                                        
        #######        #######          
       #.......#      #.......#         
       #.......########.......#         
 #######......................#######   
#....................................#  
#..............########..............#  
#..............#      #..............#  
#..............#       ########......#  
#......########               #......#  
#......#                      #......#  
#......#     ######       #####......#  
 ######     #......#     #......#####   
            #......###   #......#       
            #.........#  #......#       
           ##.........#  #......#       
          #...........#  #......#       
          #...........####......#       
          #.....................#       
          #................#####        
          #......###.......#            
          #......# #.......######       
          #......# #.............#      
      ###########  #.............#      
     #.......#     #.............#      
     #.......####  #.............#      
     #...........#  #............#      
 #####...........#  #............###### 
#................# #..................#
#................# #......###..........#
#................###......#  #.........#
#.........................#  #.........#
#.........................#  #.........#
#.........................#  #.........#
#.........................#  #.........#
 ##......####.......######   #.......## 
  #......#  #.......#         #######   
   ######   #.......#                   
             #######                    
