                                                                                                                                            
                                                                                                         ##############################     
                                                               ##############################           #..............................#    
                                     ##########################..............................#          #..............................#    
                                    #........................................................#          #..............................#    
                                    #........................................................#          #..............................#    
                                    #........................................................#          #..............................#    
                                    #........................................................#          #..............................#    
                                    #........................................................#          #..............................#    
                                    #........................................................#          #..............................#    
                                    #........................................................#          #..............................#    
                                    #........................................................#          #..............................#    
                                    #........................................................#          #..............................#    
                                    #........................................................#          #..............................#    
                                    #........................................................#          #..............................#    
                                    #........................................................#          #..............................#    
                                    #........................................................#          #..............................#    
                                    #........................................................#          #..............................#    
                               ######........................................................#          #..............................#    
                              #..............................................................#          #..............................#    
                              #..............................................................#          #..............................#    
                              #..............................................................########   #..............................#    
                              #......................................................................####..............................#    
                              #........................................................................................................#    
                              #........................................................................................................#    
                            ###........................................................................................................#    
                           #...........................................................................................................#    
                           #...........................................................................................................#    
                           #...........................................................................................................#    
                           #...........................................................................................................#    
                           #...........................................................................................................#    
                           #...........................................................................................................#    
                           #...........................................................................................................#    
                           #...........................................................................................................#    
                           #...........................................................................................................#    
                           #...........................................................................................................#    
                           #....................................................................................#######################     
                           #....................................................................................#                           
                           #....................................................................................#                           
                           #....................................................................................#                           
                           #....................................................................................############                
                           #................................................................................................#               
                           #................................................................................................#               
                           #................................................................................................#               
                           #................................................................................................#               
                           #................................................................................................#               
                           #................................................................................................#               
                           #................................................................................................#               
                           #................................................................................................#               
                           #................................................................................................#               
                           #................................................................................................#               
                           #................................................................................................#               
                           #................................................................................................#               
                           #................................................................................................#               
                           #................................................................................................#               
                           #................................................................................................#               
                           #................................................................................................#               
                            ##########################......................................................................#               
                                                     #......................................................................#               
                                                     #......................................................................#               
                                                     #......................................................................#               
                                                     #......................................................................#               
                                                     #......................................................................#               
                                                     #......................................................................#               
                                                     #......................................................................#               
                                                      ###############################.......................................#               
                                                                                    #.......................................#               
                                                                                    #.......................................#               
                                                                                    #.......................................#               
                                                                                    #.......................................#               
                                                                                    #.......................................#               
                                                                                    #..............................#########                
                                                                                    #..............................#                        
                                                                                    #..............................#                        
                                                                                    #..............................#                        
                   ###############################                                  #..............................#                        
                  #...............................#                                 #..............................#                        
                  #...............................#                                 #..............................#                        
                  #...............................#                                 #..............................#                        
                  #...............................#                                 #..............................###################      
                  #...............................#                                 #.................................................#     
                  #...............................#                                 #.................................................#     
                  #...............................#                                 #.................................................#     
                  #...............................#                                 #.................................................#     
                  #...............................#                                 #.................................................#     
                  #...............................#                                  ##################...............................#     
                  #...............................#                                                   #...............................#     
                  #...............................###############################        ##############...............................#     
                  #..............................................................#      #.............................................#     
                  #..............................................................#      #.............................................#     
                  #..............................................................#      #.............................................#     
                  #..............................................................########.............................................#     
                  #...................................................................................................................#     
                  #...................................................................................................................#     
                  #...................................................................................................................#     
                  #...................................................................................................................#     
                  #...................................................................................................................#     
                  #...................................................................................................................#     
                  #...................................................................................................................#     
                  #...................................................................................................................#     
                  #...................................................................................................................#     
                  #...................................................................................................................#     
                  #...................................................................................................................#     
                  #...................................................................................................................#     
                  #...................................................................................................................#     
                  #...................................................................................................................#     
                  #...................................................................................................................#     
                  #...................................................................................................................#     
                  #...................................................................................................................#     
                  #...................................................................................................................#     
                  #...................................................................................................................#     
                  #....................................................................................................###############      
                  #....................................................................................................#                    
                   ################################....................................................................#                    
                                                  #....................................................................#                    
                                                  #....................................................................#                    
                                                  #....................................................................#                    
                                                  #....................................................................#                    
                                                   #######.............................................................#                    
                                                         #...............................##############################                     
                                                         #..............................#                                                   
                                                         #..............................#                                                   
                                                         #..............................#                                                   
                                                          ##############################                                                    
                                                                                                                                            
                                                                                                                                            
                                                                                                                                            
                                                                                                                                            
                                                                                                                                            
                                                                                                                                            
                                                                                                                                            
                                                                                                                                            
                                                                                                                                            
                                                                                                                                            
                                                                                                                                            
                                                                                                                                            
                                                                                                                                            
                                                                                                                                            
                                                                                                                                            
                                                                                                                                            
