                            #######     
   #######                 #.......#    
  #.......#                #.......#    
  #.......#                #.......#    
  #.......########         #.......#    
  #.......#.......#        #.......#    
  #.......#.......#  #######.......#    
  #.......#.......# #......########     
  #.......#.......# #......#            
   ########.......###.......#           
          #.......#.........#           
          #......##.........#           
          #......##.........#           
          #......##.........#           
          #......##.........#           
          #..............#####          
          #...................#         
           ##......####.......#  ###### 
            #......#  #.......# #......#
            #......#  #.......# #......#
            #......####.......##.......#
             #................##.......#
             #............#### #.......#
             #............#    #.......#
             #............######.......#
             #.........................#
             #.........................#
              ############.............#
                         #.............#
                        #..............#
          #######       #..............#
         #.......#    ###..............#
         #.......#   #............##### 
         #.......#   #..........##      
         #.......#   #..........#       
         #.......#   #..........#       
         #.......#   #..........#       
          #######    #......####        
                      ######            
                                        
