                            #######     
                           #.......#    
            ######         #.......#    
           #......#        #.......#    
           #......#     ###........#    
           #.......#####...........#    
           #.......................#    
           #.......................#    
           #......####............#     
            ######    #..........#      
                      #..........#      
                      #..........#      
                 ######..........#      
                #................#      
                #.......#########       
          #######..............#        
         #.....................#        
         #.....................#        
         #......###............#        
         #......# #............#        
         #......###............#        
         #.................####         
          #..............##             
          #.........#####  #######      
          #.........#     #.......#     
          #.........#     #.......#     
       ####..........#    #.......#     
      #..............#    #.......#     
      #..............#    #.......#     
      #.......#......######.......#     
      #.......#...................#     
      #.......#...................#     
      #.......#...................#     
      #.......########.......#####      
       #######       #.......#          
                     #.......#          
                      #######           
                                        
                                        
                                        
