                            #######     
   #######                 #.......#    
  #.......#                #.......#    
  #.......#                #.......#    
  #.......########         #.......#    
  #...............#        #.......#    
  #.......#.......#  #######.......#    
  #.......#.......# #..........####     
  #.......#.......# #..........#        
   ########.......###.......###         
          #.......#.........#           
          #.......#.........#           
          #.......#.........#           
          #.......#.........#           
          #.......#.........#           
          #..............#####          
          #...................#         
           ##......####.......#  ###### 
            #......#  #.......# #......#
            #......#  #.......# #......#
            #......####.......##.......#
             #................##.......#
             #............#### #.......#
             #............#    #.......#
             #............######.......#
             #.........................#
             #.........................#
              ############.............#
                         #.............#
                        #..............#
          #######       #..............#
         #.......#    ###............/.#
         #.......#####............##### 
         #......................##      
         #......................#       
         #.......#####..........#       
         #.......#   #..........#       
          #######    #......####        
                      ######            
                                        
