                             #######    
   #######                  #.......#   
  #.......#                 #.......#   
  #.......# #######         #.......#   
  #.......##.......#        #.......#   
  #.......##.......#        #.......#   
  #................#        #.......#   
  #................#         #######    
   ###.............#   #######  ####### 
     #.............#  #.......##.......#
     #.............#  #.......##.......#
     #......##......# #.......##.......#
     #......##......# #................#
     ####### #......# #................#
    #......# #......# #................#
 ####......# #......#  ##..............#
#..........# #......#   #............## 
#..........#  ######    #............#  
#..........#            #............#  
#..........#             ##..........#  
#........#########      ###..........#  
#........##.......#    #.........####   
 #................#    #......###       
 #................#    #......#         
 #................#    #......#         
 #................#    #......#         
  #######.........#    #......#         
       #.........#     #......#         
       #.........#      ######          
       #.........#                      
       #.......## ######   #######      
       #.......# #......# #.......#     
       #.......# #......# #.......#     
        #######  #......# #.......#     
                 #......# #.......#     
                 #......# #.......#     
                 #......# #.......#     
                  ######  #.......#     
                           #######      
                                        
