                                                                                                                                            
                                                                                                         ##############################     
                                                               ##############################           #..............................#    
                                     ##########################..............................#          #..............................#    
                                    #........................................................#          #..............................#    
                                    #........................................................#          #..............................#    
                                    #........................................................#          #..............................#    
                                    #........................................................#          #..............................#    
                                    #........................................................#          #..............................#    
                                    #........................................................#          #..............................#    
                                    #........................................................#          #..............................#    
                                    #........................................................#          #..............................#    
                                    #........................................................#          #..............................#    
                                    #........................................................#          #..............................#    
                                    #........................................................#          #..............................#    
                                    #........................................................#          #..............................#    
                                    #........................................................#          #..............................#    
                                    #........................................................#          #..............................#    
                               ######........................................................#          #..............................#    
                              #..............................................................#          #..............................#    
                              #..............................................................#          #..............................#    
                              #..............................................................########   #..............................#    
                              #......................................................................####..............................#    
                              #........................................................................................................#    
                              #........................................................................................................#    
                            ###........................................................................................................#    
                           #...........................................................................................................#    
                           #...........................................................................................................#    
                           #...........................................................................................................#    
                           #...........................................................................................................#    
                           #...........................................................................................................#    
                           #...........................................................................................................#    
                           #...........................................................................................................#    
                           #...........................................................................................................#    
                           #...........................................................................................................#    
                           #...........................................................................................................#    
                           #....................................................................................#######################     
                           #....................................................................................#                           
                           #....................................................................................#                           
                           #....................................................................................#                           
                           #....................................................................................############                
                           #................................................................................................#               
                           #................................................................................................#               
                           #................................................................................................#               
                           #................................................................................................#               
                           #................................................................................................#               
                           #................................................................................................#               
                           #................................................................................................#               
                           #................................................................................................#               
                           #................................................................................................#               
                           #................................................................................................#               
                           #................................................................................................#               
                           #................................................................................................#               
                           #..............................................................###...............................#               
                           #................................................................................................#               
                           #................................................................................................#               
                           #................................................................................................#               
                            ##########################......................................................................#               
                                                     #......................................................................#               
                                                     #......................................................................#               
                                                     #......................................................................#               
                                                     #......................................................................#               
                                                     #......................................................................#               
                                                     #......................................................................#               
                                                     #......................................................................#               
                                                      ###############################.......................................#               
                                                                                    #.......................................#               
                                                                                    #.......................................#               
                                                                                    #.......................................#               
                                                                                    #.......................................#               
                                                                                    #.......................................#               
                                                                                    #..............................#########                
                                                                                    #..............................#                        
                                                                                    #..............................#                        
                                                                                    #..............................#                        
                   ###############################                                  #..............................#                        
                  #...............................#                                 #..............................#                        
                  #...............................#                                 #..............................#                        
                  #...............................#                                 #..............................#                        
                  #...............................#                                 #..............................###################      
                  #...............................#                                 #.................................................#     
                  #...............................#                                 #.................................................#     
                  #...............................#                                 #.................................................#     
                  #...............................#                                 #.................................................#     
                  #...............................#                                 #.................................................#     
                  #...............................#                                  ##################...............................#     
                  #...............................#                                                   #...............................#     
                  #...............................###############################        ##############...............................#     
                  #...............................#..............................#      #.............................................#     
                  #...............................#..............................#      #.............................................#     
                  #...............................#..............................#      #.............................................#     
                  #...............................#..............................########.............................................#     
                  #...............................#.....................................#.............................................#     
                  #...............................#.....................................#.............................................#     
                  #...............................#.....................................#.............................................#     
                  #...............................#.....................................#.............................................#     
                  #...............................#.....................................#.............................................#     
                  #...............................#.....................................#.............................................#     
                  #...............................#.....................................#.............................................#     
                  #...............................#.....................................#.............................................#     
                  #...............................#.....................................#.............................................#     
                  #...............................#.....................................#.............................................#     
                  #...............................#.....................................#.............................................#     
                  #...............................#.....................................#.............................................#     
                  #...............................#.....................................#.............................................#     
                  #...............................#.....................................#.............................................#     
                  #..............................##.....................................#.............................................#     
                  #..............................##.....................................#.............................................#     
                  #..............................##.....................................#.............................................#     
                  #..............................##.....................................#.............................................#     
                  #..............................##.....................................#.............................................#     
                  #..............................##.....................................#..............................###############      
                  #..............................##.....................................#..............................#                    
                   ############################## #.....................................#..............................#                    
                                                  #.....................................#..............................#                    
                                                  #.....................................#..............................#                    
                                                  #.....................................#..............................#                    
                                                  #.....................................#..............................#                    
                                                   #######..............................#..............................#                    
                                                         #..............................###############################                     
                                                         #..............................#                                                   
                                                         #..............................#                                                   
                                                         #..............................#                                                   
                                                          ##############################                                                    
                                                                                                                                            
                                                                                                                                            
                                                                                                                                            
                                                                                                                                            
                                                                                                                                            
                                                                                                                                            
                                                                                                                                            
                                                                                                                                            
                                                                                                                                            
                                                                                                                                            
                                                                                                                                            
                                                                                                                                            
                                                                                                                                            
                                                                                                                                            
                                                                                                                                            
                                                                                                                                            
