                                        
                                        
        #######        #######          
       #.......#      #.......#         
       #.......#      #.......#         
 #######.......#      #.......#######   
#......#.......#      #.......#......#  
#......#.......#      #.......#......#  
#......#.......#      #.......#......#  
#......#.......#       ########......#  
#......########               #......#  
#......#                      #......#  
#......#     ######       #####......#  
 ######     #......#     #......#####   
            #......###   #......#       
            #.........#  #......#       
           ##.........#  #......#       
          #...........#  #......#       
          #...........####......#       
          #.....................#       
          #................#####        
          #......###.......#            
          #......# #.......######       
          #......# #.............#      
      ###########  #.............#      
     #.......#     #.............#      
     #.......####  #.............#      
     #...........#  #######......#      
 #####...........#  #######......###### 
#................# #......######.......#
#................# #......#   ##.......#
#................###......#  #.........#
#.........................#  #.........#
#.........................#  #.........#
#.........................#  #.........#
#.........................#  #.........#
 ##......####.......######   #.......## 
  #......#  #.......#         #######   
   ######   #.......#                   
             #######                    
