                                        
 ######                                 
#......###########                      
#.................#  #######            
#.................# #.......#           
#.................# #.......#           
#.................# #.......#           
#.................###.......#           
#...........................#           
 ######.....................#           
       ##########...........#           
                #.........##            
                #.........#      ###### 
                #.........#     #......#
                #.........#     #......#
                #.........###  #.......#
                #............# #.......#
                #............# #.......#
                #............# #.......#
                 ###.........# #.......#
                    ##.......# #.......#
     #######         #.......# #.......#
    #.......#        #.......#  ####### 
    #.......#         #######           
  ###.......##                  ######  
 #............####  ######     #......# 
 #................##......#    #......# 
 #................##......#    #......# 
 #................##.......#   #......# 
 #................##.......#   #......# 
#..........................#   #......# 
#..........................#    ######  
#......####.........#......#            
#......#   ##.......#......#            
#......#    #.......#......#            
#......#    #.......#######             
#......#     #######                    
 ######                                 
                                        
                                        
