                             #######    
   #######                  #.......#   
  #.......#                 #.......#   
  #........########         #.......#   
  #................#        #.......#   
  #................#        #.......#   
  #................#        #.......#   
  #................#        #.......#    
   ###.............#   ########.....### 
     #.............#  #.......##.......#
     #.............#  #.......##.......#
     #......##......# #.......##.......#
     #......##......# #.......##.......#
     #.....# #......# #.......##.......#
    #......# #......# #.......##.......#
 ####......# #......#  ##.....##.......#
#..........# #......#   #.....#......## 
#..........#  ######    #............#  
#..........#            #............#  
#.........##            #............#  
#........#   #####      #...........#  
#........####.....#    #.........###   
 #................#    #......###       
 #................#    #......#         
 #................#    #......#         
  #...............#    #......#         
  ########.........#   #......#         
          #.........#   #.....#         
           #.........#   #.....#         
            #.........#   #.....#       
             #.........###.......#     
              #...................#     
               #..................#     
                #.................#     
                 #................#     
                  #########.......#     
                           #######      
                                        
