                                                                       
 ######                                                                
#......###########                                                     
#.................#  #######                                           
#.................# #.......#                                          
#.................# #.......#                                          
#.................# #.......#                                          
#.................###.......#                                          
#...........................#                                          
 ######.....................#                                          
       #########............#                                          
                #.........##          ################################ 
                #.........#      ######.........../-----\............# 
                #.........#     #................/       \...........# 
                #.........#     #.............../         \..........# 
                #.........###  #................|  SHOP   |..........# 
                #............###................|    _    |..........# 
                #...............................|   |.|   |..........# 
                #...............................-----.-----..........# 
                 ###.................................................# 
                    ##.......###.....................................# 
     #######         #.......# #.....................................# 
    #.......#        #.......#  ###################################### 
    #.......#         #....##                                          
  ###.......##        #....#    ######                                 
 #............#########....#   #......#                                
 #................#........#####......#                                
 #................#...................#                                
 #................#...................#                                
 #................#........#####......#                                
#..........................#   #......#                                
#..........................#    ######                                 
#......####.........#......#                                           
#......#   ##.......#......#                                           
#......#    #.......#......#                                           
#......#    #.......#######                                            
#......#     #######                                                   
 ######                                                                
                                                                       
                                                                       
