                                                            
                                                            
                                                            
                                                            
      #####                                                 
     ##...##                                                
     #.....#                            ########            
    ##.....##                          ##......##           
    #...<...#                         ##........##          
    #.......#                         #..........#          
    #.......#                       ###.......>..#          
    #.......#                      ##............##         
    #.......#                   ####..............#         
    #.......#                  ##.................#         
    #.......#                 ##................###         
    ##.....##                ##.......##.......##           
     #......##               #...#######..!...##            
     ##....$.###             #..##     ########             
      ####.....##            #.##                           
         ###../.##           #.#                            
           ##....###         #+#                            
            ##.....##       ##.#                            
             ###..%.##      #..##                           
               ##....###   ##...#                           
                ##.....#####....#                           
                 ###............#                           
                   ##..;........#                           
                    #..........##                           
                    ##.........#                            
                     ##....&...#                            
                      ####...##                             
                         #####                              
                                                            
                                                            
                                                            
                                                            
