                          #.......#                         
                          #.......#                         
                          #.......###                       
                          #.........##                      
                          #..........##                     
                          ##..........##                    
                           #...........##                   
                           ###..........##                  
                             ##..........##                 
                              ##..........#       ###       
####################           #..........#      ##.###     
....................#          #..........#    ##.....##    
....................##         #..........######.......#    
.....................###      ##..........+........?....#   
........................##    #...........######........#   
.........................#####............#    #........#   
##############............................#    ##......##   
             ##...........................#     ###...##    
              ##..........................#       #####     
               ##.........................#                 
                ##.......................##                 
                 ##.....................##                  
                  ##...................##                   
                   ##..................#                    
                    ##...............##                     
                     ##.............##                      
                      ###.........##                        
                       ###......##                          
                         #######                            
                                                            
                                                            
                                                            
                                                            
                                                            
                                                            
                                                            
