                                                            
                                                            
                                                            
                                                            
      #####                                                 
     ##   ##                                                
     #     #                            ########            
    ##     ##                          ##      ##           
    #   <   #                         ##        ##          
    #       #                         #          #          
    #       #                       ###       >  #          
    #       #                      ##            ##         
    #       #                   ####              #         
    #       #                  ##                 #         
    #       #                 ##     !          ###         
    ##     ##                ##                ##           
     #      ##               #   #######      ##            
     ##    $ ###             #  ##     ########             
      ####     ##            # ##                           
         ###  / ##           # #                            
           ##    ###         #+#                            
            ##     ##       ## #                            
             ###  % ##      #  ##                           
               ##    ###   ##   #                           
                ##     #####    #                           
                 ###            #                           
                   ##           #                           
                    #          ##                           
                    ##         #                            
                     ##    &   #                            
                      ####   ##                             
                         #####                              
                                                            
                                                            
                                                            
                                                            